b######d######b
#.............#
#.............#
#.............#
#.............#
#.............#
#.............#
d.............d
#.............#
#.............#
#.............#
#.............#
#.............#
#.............#
b######d######b
