b######d######b
#.............#
#.b.......ll..#
#.........k...#
#.........ll..#
#.............#
#.............#
d.............d
#......a......#
#.....aa......#
#...o.........#
#.............#
#.k...........#
#.............#
b######d######b
