b######d######b
#.....sss.....#
#.....sss.....#
#..bl.sss.lb..#
#..k.......k..#
#.............#
#sss.......sss#
dsss.......sssd
#sss.......sss#
#.............#
#..k.......k..#
#..bl.sss.lb..#
#.....sss.....#
#.....sss.....#
b######d######b
