b######d######b
#.....sss.....#
#.....sss.....#
#.....sss.....#
#..naa...aa...#
#ssnaa...aasss#
#sss.....mmsss#
dsss.......sssd
#sss.......sss#
#...aa..naa...#
#...aa..naa...#
#.....sssmm...#
#.....sss.....#
#.....sss.....#
b######d######b
