biiiiiieiiiiiib
jo....sss.....h
j.....sss.....h
j.....sss.....h
j.............h
j.............h
jsss.......sssh
fsss.......sssd
jsss.......sssh
j.............h
j.............h
j.....sss.....h
j.....sss.....h
j.....sss.....h
bggggggcggggggb
