biiiiiieiiiiiib
j.....sss.....h
j.....sss.....h
j..bl.sss.lb..h
j..k.......k..h
j.............h
jsss.......sssh
fsss.......sssd
jsss.......sssh
j.............h
j..k.......k..h
j..bl.sss.lb..h
j.....sss.....h
j.....sss.....h
bggggggcggggggb
